1111111111
1C00000001
10O0P00001
1000000E01
1111111111
