1111111111
1C00000001
1000P01101
1000001E01
1111111111
