111111111111111111111111111111
1E0000C00000000C00000C00000001
101001010010000010100100010101
1010010010101010001001C0100001
1P0000000C00C00000000001010C01
111111111111111111111111111111