111111111
1PEC00001
11110C001
100000011
111111111
